TILE_SET DATA/Tiles/ATLAS.png ;
SIZE 32;
LINEBREAKS 32;
COLLUMNS 32;
01,01,01,01,01,01,01,01,01,01,641,642,108,108,108,171,173,1769,1770,1771,1772,171,173,161,105,105,161,1781,1782,1783,1784,161,01,
01,01,01,01,01,01,01,01,01,693,694,108,108,108,171,173,1821,1822,1823,1824,171,173,107,107,105,105,1833,1834,1835,1836,105,01,
940,941,941,941,941,941,941,941,941,745,746,108,108,108,171,173,1873,1874,1875,1876,171,173,107,107,107,107,1885,1886,1887,1888,105,01,
992,318,319,319,319,319,319,319,320,797,798,108,108,108,171,173,1925,1926,1927,1928,171,173,107,105,105,107,1937,1938,1939,1940,105,01,
992,370,318,319,319,319,319,320,372,744,107,108,108,108,171,173,106,106,106,106,171,173,105,105,105,105,107,128,129,129,130,01,
992,370,370,278,279,279,280,372,372,796,319,319,319,319,319,319,319,319,319,319,319,319,319,320,107,107,107,232,233,77,182,01,
992,370,370,330,781,781,332,372,372,389,131,132,132,132,132,132,132,132,132,132,132,132,133,372,470,471,107,107,107,180,182,01,
992,370,370,330,781,781,332,372,372,389,183,184,184,184,184,184,184,184,184,184,184,184,185,372,522,523,105,107,107,180,182,01,
992,370,370,382,371,371,384,372,372,389,183,184,290,291,291,291,292,184,184,184,184,184,185,372,574,575,470,471,107,180,182,01,
992,370,370,371,371,371,371,372,372,389,183,184,342,348,343,348,344,184,184,184,184,184,185,372,107,107,522,523,105,180,182,01,
992,370,422,419,420,420,421,424,372,389,183,184,394,395,395,395,396,81,236,236,236,236,237,372,107,107,574,575,105,180,182,01,
992,422,423,419,420,420,421,423,424,389,183,184,184,184,184,184,184,185,266,423,423,369,423,424,107,690,691,470,471,180,182,01,
1044,1045,1045,371,371,371,371,1045,1045,389,183,184,184,184,184,184,184,185,372,783,835,159,159,107,107,107,105,522,523,180,182,01,
01,01,01,01,01,01,01,01,01,389,183,184,184,184,184,184,184,185,372,835,159,159,159,107,107,105,107,574,575,180,182,161,
105,105,105,107,107,128,129,129,129,130,183,184,184,184,184,184,184,185,319,319,319,319,319,319,319,319,319,320,107,180,182,105,
105,107,107,105,107,180,181,181,181,182,444,184,184,184,184,184,184,29,132,132,132,132,132,132,132,132,133,372,105,180,182,1336,
1337,1338,1339,107,107,180,181,181,181,182,445,184,184,184,184,184,184,184,184,184,184,184,184,184,184,184,185,372,105,180,182,1388,
1389,1390,1391,107,107,180,78,233,233,234,235,236,236,236,236,236,80,184,184,184,184,184,184,184,184,184,185,372,105,180,182,1440,
1441,1442,1443,158,107,180,182,107,159,422,423,423,423,423,423,267,183,184,184,184,184,184,184,184,184,184,185,372,105,180,182,1492,
1493,1494,1495,210,732,180,182,107,107,314,315,105,105,105,313,370,183,184,184,184,184,184,184,184,184,184,185,372,105,180,182,836,
180,181,181,129,129,25,182,107,107,366,367,105,105,105,365,370,183,184,184,184,184,184,184,184,184,184,185,372,105,180,182,105,
232,233,233,233,233,98,182,107,105,105,107,105,105,105,313,370,183,184,184,184,184,184,184,184,184,184,185,372,105,180,182,105,
105,105,107,107,105,180,182,107,107,105,105,107,105,105,365,370,183,184,184,184,184,184,184,184,184,184,185,372,105,180,182,161,
161,161,161,161,161,180,182,161,161,161,161,161,161,105,105,370,235,236,236,236,236,236,236,236,236,236,237,372,105,180,182,161,
1789,1790,1791,1792,1793,180,182,1801,1802,1803,1804,1805,161,105,105,422,423,423,423,423,369,423,423,419,420,420,421,424,105,180,182,161,
1841,1842,1843,1844,1845,180,182,1853,1854,1855,1856,1857,161,107,105,107,186,187,188,107,107,744,105,128,129,129,129,129,129,25,182,161,
1893,1894,1895,1896,1897,180,182,1905,1906,1907,1908,1909,161,105,105,105,186,187,188,107,107,796,107,180,78,233,233,233,233,233,234,161,
1945,1946,1947,1948,1949,180,182,1957,1958,1959,1960,1961,161,105,105,161,186,187,188,161,107,107,107,180,182,107,105,105,105,105,105,161,
1997,1998,1999,2000,2001,180,182,2009,2010,2011,2012,2013,161,128,130,633,634,635,636,637,128,129,129,25,182,107,105,105,105,105,105,161,
105,149,150,150,150,46,47,150,150,150,150,129,129,25,182,685,686,687,688,689,180,181,78,233,234,105,105,105,105,472,473,105,
105,232,233,233,233,233,254,254,254,254,254,233,233,233,234,737,738,739,740,741,232,233,234,105,105,105,105,105,105,524,525,105,
105,837,838,105,105,105,105,105,105,105,105,105,105,105,105,161,186,187,188,161,105,105,105,105,105,105,105,105,161,576,577,
0,0,0,0,0,0,0,0,0,0,0,0,0,0,0,0,0,0,0,0,0,0,0,0,0,0,0,0,0,0,0,0,0,
1,1,1,1,1,1,1,1,1,1,1,1,1,1,1,1,1,1,1,1,1,1,1,1,1,1,1,1,1,1,1,1,1,
