TILE_SET DATA/Tiles/tilesAtlas.png ;
SIZE 32;
LINEBREAKS 32;
COLLUMNS 32;
15,16,16,16,16,16,16,16,16,16,16,16,16,16,17,13,14,17,16,16,16,16,16,16,16,16,16,16,16,16,16,19,169,
80,85,85,85,85,85,85,85,85,85,85,85,85,39,35,36,39,85,85,85,85,85,85,85,85,85,85,85,85,86,41,169,
148,00,01,01,01,01,01,01,01,01,01,01,01,01,01,01,01,01,01,01,01,01,01,01,01,01,01,01,02,108,41,37,
148,22,23,23,23,23,23,23,23,217,218,23,23,23,23,23,23,23,23,217,218,23,23,23,23,23,23,23,24,108,41,37,
60,22,23,23,23,247,23,23,23,239,240,23,23,23,23,23,23,23,23,239,240,23,23,23,247,23,23,23,24,108,41,37,
148,22,23,23,23,269,23,23,23,23,23,23,23,23,33,23,23,23,23,23,23,23,23,23,269,23,23,23,24,108,41,37,
148,22,23,23,23,23,23,23,23,23,23,23,49,23,23,23,23,49,23,23,23,23,23,23,23,23,23,23,24,108,41,37,
148,22,23,23,23,247,23,23,07,08,09,09,09,09,09,08,08,09,09,09,09,10,23,23,247,23,23,23,24,108,41,37,
148,22,23,23,23,269,23,23,51,52,52,52,52,52,52,52,52,52,52,52,52,32,23,23,269,23,23,23,24,108,41,37,
148,22,23,23,23,23,23,23,51,52,52,52,52,52,52,52,52,52,52,52,52,32,23,23,23,23,23,23,24,108,41,37,
148,22,23,23,23,247,23,23,51,52,52,52,52,52,52,52,52,52,52,52,52,32,23,23,247,23,23,23,24,108,41,37,
148,22,23,23,23,269,23,23,51,52,52,52,52,52,52,52,52,52,52,52,52,32,23,23,269,23,23,23,24,108,41,37,
148,22,23,23,23,23,23,23,51,52,52,52,52,52,52,52,52,52,52,52,52,32,23,23,23,23,23,23,24,108,41,37,
148,22,23,23,23,247,23,23,51,52,52,52,52,52,52,52,52,52,52,52,52,32,23,23,247,23,23,23,24,108,41,37,
148,22,23,23,23,269,23,23,51,52,52,52,52,52,52,52,52,52,52,52,52,32,23,23,269,23,23,23,24,108,41,37,
148,22,23,23,23,23,23,23,51,52,52,52,52,52,52,52,52,52,52,52,52,32,23,23,23,23,23,23,24,108,41,37,
148,22,23,23,23,247,23,23,51,52,52,52,52,52,52,52,52,52,52,52,52,32,23,23,247,23,23,23,24,108,41,37,
148,22,23,23,23,269,23,23,51,52,52,52,52,52,52,52,52,52,52,52,52,32,23,23,269,23,23,23,24,108,41,37,
148,22,23,23,23,23,23,23,73,75,75,75,75,75,75,75,75,75,75,75,75,76,23,23,23,23,23,23,24,108,41,37,
148,22,23,23,23,247,23,23,23,23,23,23,23,23,23,23,23,23,23,23,23,23,23,23,247,23,23,23,24,108,41,37,
148,22,23,23,23,269,23,23,49,23,23,23,23,23,23,23,23,23,23,23,23,49,23,23,269,23,23,23,24,108,41,37,
148,22,23,23,23,23,23,23,23,23,23,23,23,23,23,23,23,23,23,23,23,23,23,23,23,23,23,23,24,108,41,37,
148,22,23,23,23,23,23,23,23,23,23,23,23,23,23,23,23,23,23,23,23,23,23,23,23,23,23,23,24,108,41,37,
148,22,23,23,23,23,23,23,23,23,23,23,330,23,23,23,23,23,330,23,23,23,23,23,23,23,23,23,24,108,41,37,
148,22,03,04,23,23,23,23,23,23,23,23,352,23,23,23,23,23,352,23,23,23,23,23,23,23,03,04,24,108,41,37,
148,22,25,26,23,23,23,23,23,23,23,23,352,23,23,23,23,23,352,23,23,23,23,23,23,23,25,26,24,108,41,37,
148,22,23,23,23,23,23,23,23,23,23,23,374,23,23,23,23,23,352,23,23,23,23,23,23,23,23,23,24,108,41,37,
148,22,23,23,23,23,23,23,23,23,23,23,396,23,23,23,23,23,352,23,23,23,23,23,23,23,23,23,24,108,41,37,
148,22,23,23,23,23,23,23,23,23,23,23,418,23,23,23,23,23,418,23,23,23,23,23,23,23,23,23,24,108,41,37,
148,44,45,45,45,45,45,45,45,45,45,45,440,45,45,45,45,45,440,45,45,45,45,45,45,45,45,45,46,108,41,37,
170,125,125,125,125,125,125,125,125,125,125,125,125,286,287,288,289,290,125,125,125,125,125,125,125,125,125,125,125,130,41,191,
152,152,152,152,152,152,152,152,152,152,146,146,146,311,309,310,311,312,146,152,152,152,152,152,152,152,152,152,152,152,153,