TILE_SET DATA/Tiles/ATLAS.png ;
SIZE 32;
LINEBREAKS 32;
COLLUMNS 32;
01,105,104,104,104,104,104,104,104,104,104,104,104,104,104,104,104,104,104,104,104,104,104,104,104,104,104,104,104,104,104,104,106,
105,112,113,113,113,113,113,113,113,113,113,113,113,113,113,113,113,113,114,108,108,108,108,108,108,108,108,108,108,104,104,105,
105,164,743,165,165,165,165,165,165,165,165,165,165,165,165,743,165,165,166,108,108,108,108,108,108,108,108,108,108,104,104,105,
105,164,795,165,165,165,165,165,165,165,165,165,165,165,165,795,165,165,166,108,108,108,108,108,108,108,108,108,108,104,104,105,
106,164,165,268,269,269,269,269,269,269,269,269,269,269,270,165,165,165,166,108,108,108,108,108,108,108,108,108,108,104,104,105,
106,164,165,320,109,110,110,110,110,110,110,110,110,111,322,165,165,165,166,108,108,108,108,108,108,108,108,1799,1799,104,104,105,
106,164,165,320,161,162,162,162,162,162,162,162,162,163,322,165,165,165,166,108,108,108,108,108,108,108,108,1799,1799,104,104,105,
105,164,165,320,161,162,162,162,162,162,162,162,162,163,322,165,165,165,166,108,108,108,108,2058,2059,2060,2061,2062,108,104,104,105,
105,164,165,320,161,162,162,162,162,162,162,162,162,163,322,165,165,165,166,108,108,108,108,2110,2111,2112,2113,2114,108,104,104,105,
105,164,165,320,161,162,162,162,162,162,162,162,162,163,322,165,165,165,166,108,108,108,108,2162,2163,2164,2165,2166,108,104,104,106,
104,164,165,320,161,162,162,162,162,162,162,162,162,163,322,165,165,165,166,108,108,108,108,2214,2215,2215,2215,2218,108,104,104,104,
104,164,165,320,161,162,162,162,162,162,162,162,162,163,322,165,165,165,166,108,108,108,108,2266,2215,2215,2269,2218,108,104,104,104,
104,164,165,320,161,162,162,162,162,162,162,162,162,163,322,165,165,165,166,108,108,108,108,2318,2267,2267,2269,2270,108,104,104,104,
104,164,165,320,161,162,162,162,162,162,162,162,162,163,322,165,165,165,166,108,108,108,108,2318,2319,2320,2321,2322,108,104,104,104,
104,164,165,320,161,162,162,162,162,162,162,162,162,163,322,165,165,165,166,108,108,108,108,2370,2371,2372,2373,2374,108,104,104,104,
104,164,165,320,161,162,162,162,162,162,162,162,162,163,322,165,165,165,166,108,108,108,108,108,108,108,108,108,108,104,104,104,
104,164,165,320,161,162,162,162,162,162,162,162,162,163,322,165,165,165,166,108,108,108,108,108,108,108,108,108,108,104,104,104,
104,164,165,320,213,214,214,214,214,214,214,214,214,215,322,165,165,165,166,646,647,108,108,108,108,108,108,108,108,104,104,104,
104,164,165,372,373,373,373,373,373,373,373,373,373,373,374,165,165,165,166,698,699,108,108,108,108,108,108,108,108,104,104,104,
104,164,743,165,165,165,165,165,165,165,165,165,165,165,165,743,165,165,166,108,108,108,108,108,108,108,108,108,108,104,104,104,
104,164,795,165,424,165,165,165,165,165,165,165,165,165,165,795,165,165,166,108,108,108,108,108,108,108,108,108,108,104,104,104,
104,164,165,165,165,165,165,165,165,165,165,165,165,165,165,165,165,165,166,108,108,108,108,108,108,108,108,108,108,104,104,104,
104,216,217,217,217,217,217,217,217,217,217,217,217,217,217,217,217,217,218,108,108,108,108,108,108,108,108,108,108,104,104,104,
104,160,160,160,160,160,160,160,160,160,104,937,937,937,937,104,104,104,104,104,104,104,104,104,108,108,108,104,104,104,104,104,
104,160,121,122,122,122,122,122,123,160,212,937,937,937,937,104,104,104,212,124,125,125,125,125,125,125,125,125,125,126,104,104,
104,160,173,174,174,174,174,174,175,160,264,104,104,104,104,104,104,104,264,176,177,177,177,177,177,177,177,177,177,178,104,104,
104,160,173,174,174,174,174,174,175,160,105,104,104,104,104,104,104,104,104,176,177,177,177,177,177,177,177,177,177,178,104,104,
104,160,173,174,174,174,174,174,175,160,104,640,641,104,104,104,104,104,104,176,177,177,177,177,177,177,177,177,177,178,104,104,
104,160,225,226,226,226,226,226,227,160,104,692,693,104,104,104,104,104,104,176,177,177,177,177,177,177,177,177,177,178,104,104,
104,160,160,160,160,160,160,160,160,160,104,744,745,104,104,104,104,104,104,228,229,229,229,229,229,229,229,229,229,230,104,104,
104,104,104,104,104,104,104,104,104,104,104,796,797,104,104,104,104,104,104,104,104,104,104,104,104,104,104,104,104,104,104,104,
104,104,104,104,104,104,104,104,104,104,104,104,104,104,104,104,104,104,104,104,104,104,104,104,104,104,104,104,104,104,104,
0,0,0,0,0,0,0,0,0,0,0,0,0,0,0,0,0,0,0,0,0,0,0,0,0,0,0,0,0,0,0,0,
0,0,0,0,0,0,0,0,0,0,0,0,0,0,0,0,0,0,0,0,0,0,0,0,0,0,0,0,0,0,0,0,
0,0,0,0,0,0,0,0,0,0,0,0,0,0,0,0,0,0,0,0,0,0,0,0,0,0,0,0,0,0,0,0,
0,0,0,0,0,0,0,0,0,0,0,0,0,0,0,0,0,0,0,0,0,0,0,0,0,0,0,0,0,0,0,0,
0,0,0,0,0,0,0,0,0,0,0,0,0,0,0,0,0,0,0,0,0,0,0,0,0,0,0,0,0,0,0,0,
0,0,0,0,0,0,0,0,0,0,0,0,0,0,0,0,0,0,0,0,0,0,0,0,0,0,0,0,0,0,0,0,
0,0,0,0,0,0,0,0,0,0,0,0,0,0,0,0,0,0,0,0,0,0,0,0,0,0,0,0,0,0,0,0,
0,0,0,0,0,0,0,0,0,0,0,0,0,0,0,0,0,0,0,0,0,0,0,0,1,1,1,1,1,0,0,0,
0,0,0,0,0,0,0,0,0,0,0,0,0,0,0,0,0,0,0,0,0,0,0,0,1,1,1,1,1,0,0,0,
0,0,0,0,0,0,0,0,0,0,0,0,0,0,0,0,0,0,0,0,0,0,0,0,1,0,0,0,1,0,0,0,
0,0,0,0,0,0,0,0,0,0,0,0,0,0,0,0,0,0,0,0,0,0,0,0,1,0,0,0,1,0,0,0,
0,0,0,0,0,0,0,0,0,0,0,0,0,0,0,0,0,0,0,0,0,0,0,0,1,0,0,0,1,0,0,0,
0,0,0,0,0,0,0,0,0,0,0,0,0,0,0,0,0,0,0,0,0,0,0,0,1,0,0,0,1,0,0,0,
0,0,0,0,0,0,0,0,0,0,0,0,0,0,0,0,0,0,0,0,0,0,0,0,1,0,2,0,1,0,0,0,
0,0,0,0,0,0,0,0,0,0,0,0,0,0,0,0,0,0,0,0,0,0,0,0,1,1,2,1,1,0,0,0,
0,0,0,0,0,0,0,0,0,0,0,0,0,0,0,0,0,0,0,0,0,0,0,0,0,0,0,0,0,0,0,0,
0,0,0,0,0,0,0,0,0,0,0,0,0,0,0,0,0,0,0,0,0,0,0,0,0,0,0,0,0,0,0,0,
0,0,0,0,0,0,0,0,0,0,0,0,0,0,0,0,0,0,0,0,0,0,0,0,0,0,0,0,0,0,0,0,
0,0,0,0,0,0,0,0,0,0,0,0,0,0,0,0,0,0,0,0,0,0,0,0,0,0,0,0,0,0,0,0,
0,0,0,0,0,0,0,0,0,0,0,0,0,0,0,0,0,0,0,0,0,0,0,0,0,0,0,0,0,0,0,0,
0,0,0,0,0,0,0,0,0,0,0,0,0,0,0,0,0,0,0,0,0,0,0,0,0,0,0,0,0,0,0,0,
0,0,0,0,0,0,0,0,0,0,0,0,0,0,0,0,0,0,0,0,0,0,0,0,0,0,0,0,0,0,0,0,
0,0,0,0,0,0,0,0,0,0,0,0,0,0,0,0,0,0,0,0,0,0,0,0,0,0,0,0,0,0,0,0,
0,0,0,0,0,0,0,0,0,0,0,0,0,0,0,0,0,0,0,0,0,0,0,0,0,0,0,0,0,0,0,0,
0,0,0,0,0,0,0,0,0,0,0,0,0,0,0,0,0,0,0,0,0,0,0,0,0,0,0,0,0,0,0,0,
0,0,0,0,0,0,0,0,0,0,0,0,0,0,0,0,0,0,0,0,0,0,0,0,0,0,0,0,0,0,0,0,
0,0,0,0,0,0,0,0,0,0,0,0,0,0,0,0,0,0,0,0,0,0,0,0,0,0,0,0,0,0,0,0,
0,0,0,0,0,0,0,0,0,0,0,0,0,0,0,0,0,0,0,0,0,0,0,0,0,0,0,0,0,0,0,0,
0,0,0,0,0,0,0,0,0,0,0,0,0,0,0,0,0,0,0,0,0,0,0,0,0,0,0,0,0,0,0,0,
0,0,0,0,0,0,0,0,0,0,0,0,0,0,0,0,0,0,0,0,0,0,0,0,0,0,0,0,0,0,0,0,
0,0,0,0,0,0,0,0,0,0,0,0,0,0,0,0,0,0,0,0,0,0,0,0,0,0,0,0,0,0,0,0,
0,0,0,0,0,0,0,0,0,0,0,0,0,0,0,0,0,0,0,0,0,0,0,0,0,0,0,0,0,0,0,0,
